####################
#&#...#..###.#...#&#
#.#....$.##.$....#.#
#.#.###..#...###.#.#
#.#...#......#...#.#
#.###.##.####..#.#.#
#.....##..#.#......#
#.#.#....@.....#.#.#
#......#.#..##.....#
#.#.#..####.##.###.#
#.#...#......#...#.#
#.#.###...#..###.#.#
#.#....$.##.$....#.#
#&#...#.###..#...#&#
####################