####################
##..#..#.....#######
##.$#..#.#.....#####
#...#$.#....#......#
#.#.#.#..##.#.#....#
#...#..#...#..#....#
##..#....&....#....#
#.....#.&@&.#.#..#.#
#........&....#....#
#......#...#..#.#.##
#........#....#.#..#
#.########..#.#.#$.#
#.$.........#.#....#
#.....#...#...##..##
####################