####################
#@###......#...#...#
#.###......#.$.#.$.#
#......#...#...#...#
#####..#...##.###.##
#...#..#...........#
#.$....#...........#
#####..#...#.##.####
#...#..#.#.#.##.####
#.$....#...#.##.##&#
#####..#...#.##...&#
#...####.###.#....&#
#.$..........#....&#
#######..#########&#
####################
