####################
#.....#....####....#
#.@.#.#.#........#.#
#...#...........##.#
###.#.#.#######.##.#
#...#.#.#..........#
#.#####.#...#...####
#.#..#...#.######..#
#........#.........#
##.#..##.#....#.#.##
#.....#....##..$.$.#
#....##..#....#....#
#&&#....##.##..$.$.#
#&&#.....#....#.#.##
####################