####################
#&.##..#....#......#
#..#...........#.$.#
#..#.....#..##.##..#
#.....##....#......#
#....##........#.$.#
##.####.###.#..##..#
##&@#&.............#
##.####.###.#......#
#....##........#.$.#
#.....##.....#.##..#
#..#.....#..##.....#
#..#........#..#.$.#
#&.##..#.......##..#
####################