############
#.&&.$@....#
#.$....$&&.#
#........$.#
#.....$..&.#
#.....&..&.#
#....$&..$..#
#..........#
############